40 36 
320 640 
3 3 3 3 3 3 0 0 3 3 3 3 3 3 3 3 3 3 0 0 4 4 4 4 0 0 3 3 3 3 3 3 3 3 3 3 0 0 3 3 
3 3 3 3 3 3 0 0 3 3 3 3 3 3 3 3 3 3 0 0 4 4 4 4 0 0 3 3 3 3 3 3 3 3 3 3 0 0 3 3 
0 0 0 0 0 0 0 0 0 0 0 0 0 0 0 0 0 0 0 0 4 4 4 4 0 0 0 0 0 0 0 0 0 0 0 0 0 0 0 0 
0 0 0 0 0 0 0 0 0 0 0 0 0 0 0 0 0 0 0 0 4 4 4 4 0 0 0 0 0 0 0 0 0 0 0 0 0 0 0 0 
0 0 3 3 1 1 1 1 1 1 1 1 1 1 1 1 1 1 1 1 1 1 1 1 1 1 1 1 1 1 1 1 1 1 1 1 3 3 0 0 
0 0 3 3 2 1 1 1 2 1 1 1 2 1 1 1 2 1 1 1 2 1 1 1 2 1 1 1 2 1 1 1 2 1 1 1 3 3 0 0 
0 0 3 3 1 1 1 1 0 0 0 0 0 0 0 0 1 1 1 1 1 1 1 1 0 0 0 0 0 0 0 0 1 1 1 1 3 3 0 0 
0 0 3 3 1 1 2 1 0 0 0 0 0 0 0 0 1 1 2 1 1 1 2 1 0 0 0 0 0 0 0 0 1 1 2 1 3 3 0 0 
0 0 3 3 2 2 2 2 0 0 0 0 0 0 0 0 1 1 1 1 2 2 2 2 0 0 0 0 0 0 0 0 1 1 1 1 3 3 0 0 
0 0 3 3 2 2 2 2 0 0 0 0 0 0 0 0 2 1 1 1 2 2 2 2 0 0 0 0 0 0 0 0 2 1 1 1 3 3 0 0 
0 0 3 3 2 2 0 0 0 0 0 0 0 0 0 0 1 1 1 1 2 2 0 0 0 0 0 0 0 0 0 0 1 1 1 1 3 3 0 0 
0 0 3 3 2 2 0 0 0 0 0 0 0 0 0 0 1 1 2 1 2 2 0 0 0 0 0 0 0 0 0 0 1 1 2 1 3 3 0 0 
0 0 3 3 1 1 1 1 1 1 1 1 1 1 1 1 1 1 1 1 1 1 1 1 1 1 1 1 1 1 1 1 1 1 1 1 3 3 0 0 
0 0 3 3 2 1 1 1 2 1 1 1 2 1 1 1 2 1 1 1 2 1 1 1 2 1 1 1 2 1 1 1 2 1 1 1 3 3 0 0 
0 0 3 3 1 1 1 1 1 1 1 1 1 1 1 1 1 1 1 1 1 1 1 1 1 1 1 1 1 1 1 1 1 1 1 1 3 3 0 0
0 0 3 3 1 1 2 1 1 1 2 1 1 1 2 1 1 1 2 1 1 1 2 1 1 1 2 1 1 1 2 1 1 1 2 1 3 3 0 0 
0 0 3 3 1 1 1 1 2 2 2 2 2 2 2 2 1 1 1 1 0 0 0 0 0 0 0 0 0 0 0 0 1 1 1 1 3 3 0 0 
0 0 3 3 2 1 1 1 2 2 2 2 2 2 2 2 2 1 1 1 0 0 0 0 0 0 0 0 0 0 0 0 2 1 1 1 3 3 0 0 
0 0 3 3 1 1 1 1 0 0 0 0 0 0 0 0 1 1 1 1 0 0 0 0 0 0 0 0 0 0 0 0 1 1 1 1 3 3 0 0 
0 0 3 3 1 1 2 1 0 0 0 0 0 0 0 0 1 1 2 1 0 0 0 0 0 0 0 0 0 0 0 0 1 1 2 1 3 3 0 0 
0 0 3 3 1 1 1 1 3 3 3 3 3 3 3 3 1 1 1 1 0 0 0 0 0 0 0 0 0 0 0 0 1 1 1 1 3 3 0 0 
0 0 3 3 2 1 1 1 3 0 3 0 3 0 3 0 2 1 1 1 0 0 0 0 0 0 0 0 0 0 0 0 2 1 1 1 3 3 0 0 
0 0 3 3 1 1 1 1 0 3 0 3 0 3 0 3 1 1 1 1 0 0 0 0 0 0 0 0 0 0 0 0 1 1 1 1 3 3 0 0 
0 0 3 3 1 1 2 1 3 3 3 3 3 3 3 3 1 1 2 1 0 0 0 0 0 0 0 0 0 0 0 0 1 1 2 1 3 3 0 0 
0 0 3 3 1 1 1 1 1 1 1 1 1 1 1 1 1 1 1 1 2 2 2 2 2 2 2 2 2 2 2 2 2 2 2 2 3 3 0 0 
0 0 3 3 2 1 1 1 2 1 1 1 2 1 1 1 2 1 1 1 2 2 2 2 2 2 2 2 2 2 2 2 2 2 2 2 3 3 0 0 
0 0 3 3 1 1 1 1 1 1 1 1 1 1 1 1 1 1 1 1 0 0 0 0 0 0 0 0 0 0 0 0 2 2 2 2 3 3 0 0 
0 0 3 3 1 1 2 1 1 1 2 1 1 1 2 1 1 1 2 1 0 0 0 0 0 0 0 0 0 0 0 0 2 2 2 2 3 3 0 0 
0 0 3 3 3 3 3 3 5 5 5 5 5 5 5 5 2 2 2 2 3 3 3 3 3 3 3 3 3 3 3 3 2 2 2 2 3 3 0 0 
0 0 3 3 3 3 3 3 7 0 0 0 0 0 0 6 2 2 2 2 3 0 3 0 3 0 3 0 3 3 3 3 2 2 2 2 3 3 0 0 
0 0 3 3 3 3 3 3 7 0 0 0 0 0 0 6 2 2 2 2 0 3 0 3 0 3 0 3 3 3 3 3 2 2 2 2 3 3 0 0 
0 0 3 3 3 3 3 3 7 0 0 0 0 0 0 6 2 2 2 2 3 3 3 3 3 3 3 3 3 3 3 3 2 2 2 2 3 3 0 0 
0 0 3 3 3 3 3 3 7 0 0 0 0 0 0 6 2 2 2 2 2 2 2 2 2 2 2 2 2 2 2 2 2 2 2 2 3 3 0 0 
0 0 3 3 3 3 3 3 7 0 0 0 0 0 0 6 2 2 2 2 2 2 2 2 2 2 2 2 2 2 2 2 2 2 2 2 3 3 0 0 
0 0 0 0 3 3 3 3 7 0 0 0 0 0 0 6 0 0 0 0 0 0 0 0 0 0 0 0 0 0 0 0 0 0 0 0 0 0 0 0 
0 0 0 0 3 3 3 3 7 0 0 0 0 0 0 6 0 0 0 0 0 0 0 0 0 0 0 0 0 0 0 0 0 0 0 0 0 0 0 0 

