40 36
0 0 
0 0 0 0 0 0 4 5 0 0 0 0 0 0 0 0 0 0 4 5 3 3 3 3 4 5 0 0 0 0 0 0 0 0 0 0 4 5 0 0
0 0 0 0 0 0 7 6 0 0 0 0 0 0 0 0 0 0 7 6 3 3 3 3 7 6 0 0 0 0 0 0 0 0 0 0 7 6 0 0 
4 5 4 5 4 5 4 5 4 5 4 5 4 5 4 5 4 5 4 5 3 3 3 3 4 5 4 5 4 5 4 5 4 5 4 5 4 5 4 5
7 6 7 6 7 6 7 6 7 6 7 6 7 6 7 6 7 6 7 6 3 3 3 3 7 6 7 6 7 6 7 6 7 6 7 6 7 6 7 6
4 5 0 0 1 1 1 1 1 1 1 1 1 1 1 1 1 1 1 1 1 1 1 1 1 1 1 1 1 1 1 1 1 1 1 1 0 0 4 5
7 6 0 0 2 1 1 1 1 1 1 1 2 1 1 1 2 1 1 1 2 1 1 1 2 1 1 1 2 1 1 1 2 1 1 1 0 0 7 6 
4 5 0 0 1 1 1 1 18 18 18 18 18 18 18 18 1 1 1 1 1 1 1 1 18 18 18 18 18 18 18 18 1 1 1 1 0 0 4 5
7 6 0 0 1 1 2 1 18 18 18 18 18 18 18 18 1 1 2 1 1 1 2 1 18 18 18 18 18 18 18 18 1 1 2 1 0 0 7 6
4 5 0 0 2 2 2 2 18 18 18 18 18 18 18 18 1 1 1 1 2 2 2 2 18 18 18 18 18 18 18 18 1 1 1 1 0 0 4 5
7 6 0 0 2 2 2 2 18 18 18 18 18 18 18 18 2 1 1 1 2 2 2 2 18 18 18 18 18 18 18 18 1 1 1 1 0 0 7 6
4 5 0 0 2 2 12 13 18 18 18 18 18 18 18 18 1 1 1 1 2 2 12 13 18 18 18 18 18 18 18 18 1 1 1 1 0 0 4 5
7 6 0 0 2 2 15 14 18 18 18 18 18 18 18 18 1 1 2 1 2 2 15 14 18 18 18 18 18 18 18 18 1 1 2 1 0 0 7 6 
4 5 0 0 1 1 1 1 1 1 1 1 1 1 1 1 1 1 1 1 1 1 1 1 1 1 1 1 1 1 1 1 1 1 1 1 0 0 4 5 
7 6 0 0 2 1 1 1 2 1 1 1 99 1 1 1 2 1 1 1 2 1 1 1 2 1 1 1 2 1 1 1 2 1 1 1 0 0 7 6 
4 5 0 0 1 1 1 1 1 1 1 1 1 1 1 1 1 1 1 1 1 1 1 1 1 1 1 1 1 1 1 1 1 1 1 1 0 0 4 5
7 6 0 0 1 1 2 1 1 1 2 1 1 1 2 1 1 1 2 1 1 1 2 1 1 1 2 1 1 1 2 1 1 1 2 1 0 0 7 6
4 5 0 0 1 1 1 1 2 2 2 2 2 2 2 2 1 1 1 1 18 18 18 18 18 18 18 18 18 18 18 18 2 1 1 1 0 0 4 5
7 6 0 0 2 1 1 1 2 2 2 2 2 2 2 2 2 1 1 1 18 18 18 18 18 18 18 18 18 18 18 18 1 1 1 1 0 0 7 6
4 5 0 0 1 1 1 1 8 9 8 9 8 9 12 13 1 1 1 1 18 18 18 18 18 18 18 18 18 18 18 18 1 1 2 1 0 0 4 5
7 6 0 0 1 1 2 1 11 10 11 10 11 10 15 14 1 1 2 1 18 18 18 18 18 18 18 18 18 18 18 18 1 1 2 1 0 0 7 6
4 5 0 0 1 1 1 1 0 0 0 0 0 0 0 0 1 1 1 1 18 18 18 18 18 18 18 18 18 18 18 18 1 1 1 1 0 0 4 5
7 6 0 0 2 1 1 1 0 18 0 18 0 18 0 18 2 1 1 1 18 18 18 18 18 18 18 18 18 18 18 18 2 1 1 1 0 0 7 6
4 5 0 0 1 1 1 1 18 0 18 0 18 0 18 0 1 1 1 1 18 18 18 18 18 18 18 18 18 18 18 18 1 1 1 1 0 0 4 5
7 6 0 0 1 1 1 1 0 0 0 0 0 0 0 0 1 1 2 1 18 18 18 18 18 18 18 18 18 18 18 18 1 1 2 1 0 0 7 6 
4 5 0 0 1 1 1 1 1 1 1 1 1 1 1 1 1 1 1 1 2 2 2 2 2 2 2 2 2 2 2 2 2 2 2 2 0 0 4 5 
7 6 0 0 2 1 1 1 2 1 1 1 2 1 1 1 2 1 1 1 2 2 2 2 2 2 2 2 2 2 2 2 2 2 2 2 0 0 7 6 
4 5 0 0 1 1 1 1 1 1 1 1 1 1 1 1 1 1 1 1 8 9 8 9 8 9 12 13 8 9 8 9 1 1 1 1 0 0 4 5
7 6 0 0 1 1 2 1 1 1 2 1 1 1 2 1 1 1 2 1 11 10 11 10 11 10 15 14 11 10 11 10 2 2 2 2 0 0 7 6
4 5 0 0 0 0 0 0 17 17 17 17 17 17 17 17 2 2 2 2 0 0 0 0 0 0 0 0 0 0 0 0 2 2 2 2 0 0 4 5
7 6 0 0 0 0 0 0 19 18 18 18 18 18 18 16 2 2 2 2 0 18 0 18 0 18 0 18 0 0 0 0 2 2 2 2 0 0 7 6 
4 5 0 0 0 0 0 0 19 18 18 18 18 18 18 16 2 2 2 2 18 0 18 0 18 0 18 0 0 0 0 0 2 2 2 2 0 0 4 5 
7 6 0 0 0 0 0 0 19 18 18 18 18 18 18 16 2 2 2 2 0 0 0 0 0 0 0 0 0 0 0 0 2 2 2 2 0 0 7 6 
4 5 0 0 0 0 0 0 19 18 18 18 18 18 18 16 2 2 2 2 2 2 2 2 2 2 2 2 2 2 2 2 2 2 2 2 0 0 4 5 
7 6 0 0 0 0 0 0 19 18 18 18 18 18 18 16 2 2 2 2 2 2 2 2 2 2 2 2 2 2 2 2 2 2 2 2 0 0 7 6 
4 5 4 5 0 0 0 0 19 18 18 18 18 18 18 16 4 5 4 5 4 5 4 5 4 5 4 5 4 5 4 5 4 5 4 5 4 5 4 5 
7 6 7 6 0 0 0 0 19 18 18 18 18 18 18 16 7 6 7 6 7 6 7 6 7 6 7 6 7 6 7 6 7 6 7 6 7 6 7 6







 

